6 14
001111000
100000010
101101110
101000010
101011011
001100000
4
6 1 6 5 3
5 4 1 7 8
5 4 6 1 4
6 8 4 9 10
S 1 1
E 6 9